1111111111
1C0E0101C1
1010P00C01
1000000001
1000000001
1000000001
1000000001
1000000001
1000000001
1000000101
1111111111