1111111111
1E000101C1
1010P00C01
1111111111
