1111111111111
1001000000011
11111111110C1
1P0011E000001
1111111111111